11111111111111
10001010000001
1P00000001E001
1010001100E011
10C010C000C001
11111111111111
